a			形容词


f		    方位词


mq			数量词


nn			工作相关名词


ad			副形词


g			学术词汇


n			名词


nnd			职业


ag			形容词性语素


gb			生物相关词汇


nb			生物名


nnt			职务职称


al			形容词性惯用语


gbc			生物类别


nba			动物名


nr			人名


an			名形词


gc			化学相关词汇


nbc			动物纲目


nr1			复姓


b			区别词


gg			地理地质相关词汇


nbp			植物名


nr2			蒙古姓名


begin		仅用于始##始


gi			计算机相关词汇


nf			食品，比如“薯片”


nrf			音译人名


bg			区别语素


gm			数学相关词汇


ng			名词性语素


nrj			日语人名


bl			区别词性惯用语


gp			物理相关词汇


nh			医药疾病等健康相关名词


ns			地名


c			连词


h			前缀


nhd			疾病


nsf			音译地名


cc			并列连词


i			成语


nhm			药品


nt			机构团体名


d			副词


j			简称略语


ni			机构相关（不是独立机构名）


ntc			公司名


dg			辄,俱,复之类的副词


k			后缀


nic			下属机构


ntcb		银行


dl			连语


l			习用语


nis			机构后缀


ntcf		工厂


e			叹词


m			数词


nit			教育相关机构


ntch		酒店宾馆


end			仅用于终##终


mg			数语素


nl			名词性惯用语


nth			医院


nts			中小学


Mg			甲乙丙丁之类的数词


nm			物品名


nto			政府机构


ntu			大学


ryt			时间疑问代词


nmc			化学品名


vn			名动词


nx			字母专名


ryv			谓词性疑问代词


uj			助词


vshi		动词“是”


nz			其他专名


rz			指示代词


ul			连词


vx 			形式动词


o			拟声词


rzs			处所指示代词


ule			了 喽


vyou		动词“有”


p			介词


rzt			时间指示代词


ulian		连 （“连小学生都会”）


w			标点符号


pba			介词“把”


rzv			谓词性指示代词


uls			来讲 来说 而言 说来


wb			百分号千分号，全角：％ ‰   半角：%


pbei		介词“被”


s			处所词


usuo		所


wd			逗号，全角：， 半角：,


q			量词


t			时间词


uv			连词


wf			分号，全角：； 半角： ;


qg			量词语素


tg			时间词性语素


uyy			一样 一般 似的 般


wh			单位符号，全角：￥ ＄ ￡  °  ℃  半角：$


qt			时量词


u			助词


uz			着


wj			句号，全角：。


qv			动量词


ud			助词


uzhe		着


wky			右括号，全角：） 〕  ］ ｝ 》  】 〗 〉 半角： ) ] { >


r			代词


ude1		的 底


uzhi		之


wkz			左括号，全角：（ 〔  ［  ｛  《 【  〖 〈   半角：( [ { <


rg			代词性语素


ude2		地


v			动词


wm			冒号，全角：： 半角： :


Rg			古汉语代词性语素


ude3		得


vd			副动词


wn			顿号，全角：、


rr			人称代词


udeng		等 等等 云云


vf			趋向动词


wp			破折号，全角：——   －－   ——－   半角：—  —-


ry			疑问代词


udh			的话


vg			动词性语素


ws			省略号，全角：……  …


rys			处所疑问代词


ug			过


vi			不及物动词（内动词）


wt			叹号，全角：！


wyy			右引号，全角：” ’ 』


y			语气词(delete yg)


vl			动词性惯用语


ww			问号，全角：？


wyz			左引号，全角：“ ‘ 『


yg			语气语素



x			字符串


z			状态词



xu			网址URL


zg			状态词



xx			非语素字




